MAP
30 20
10 10 10 10 10 10 10 10 10 10 10 10 10 10 10 10 10 10 10 10 10 10 10 10 10 10 10 10 10 10 
10 10 10 10 10 10 10 10 10 10 10 10 16 11 11 15 20 20 20 20 20 20 20 20 20 20 20 20 20 10 
10 21 18 18 18 18 18 18 18 18 18 18 19 11 11 17 18 18 18 18 18 18 18 22 20 20 20 20 20 10 
10 16 11 11 11 11 11 11 11 11 11 11 11 11 11 11 11 11 11 11 11 11 11 15 31 32 33 20 20 10 
10 16 11 11 11 11 11 11 11 11 11 11 11 11 11 11 11 11 11 11 11 11 11 15 34 30 35 20 20 10 
10 16 11 11 12 13 13 13 13 13 13 13 14 11 11 12 13 13 13 13 13 13 13 24 34 30 35 20 20 10 
10 16 11 11 15 20 20 20 31 33 10 10 16 11 11 15 31 32 32 33 10 10 10 10 34 30 35 20 20 10 
10 16 11 11 17 18 18 22 34 35 10 10 16 11 11 15 36 37 37 38 10 10 10 10 34 30 35 20 20 10 
10 16 11 11 11 11 11 15 34 35 10 10 16 11 11 17 18 18 18 18 18 18 18 22 34 30 35 20 20 10 
10 16 11 11 11 11 11 15 34 35 10 10 16 11 11 11 11 11 11 11 11 11 11 15 34 30 35 20 20 10 
10 23 13 13 14 11 11 15 34 35 10 10 16 11 11 11 11 11 11 11 11 11 11 15 34 30 35 20 20 10 
10 20 20 20 16 11 11 15 34 35 10 10 23 13 13 13 13 13 13 13 14 11 11 15 34 30 35 20 20 10 
10 31 32 33 16 11 11 15 36 38 10 10 10 10 10 10 10 10 10 10 16 11 11 15 34 30 35 20 20 10 
10 34 30 35 16 11 11 17 18 46 18 18 18 18 18 18 18 18 18 18 19 11 11 15 34 30 35 20 20 10 
10 34 30 35 16 11 11 11 11 45 9 9 11 11 11 11 11 11 11 11 11 11 11 15 34 30 35 20 20 10 
10 34 30 35 16 11 11 11 11 45 9 9 11 11 11 11 11 11 11 11 11 11 11 15 34 30 35 20 20 10 
10 34 30 35 23 13 13 13 13 47 13 13 13 13 13 13 13 13 13 13 13 13 13 24 36 37 38 20 20 10 
10 34 30 41 32 32 32 33 20 20 20 20 20 20 20 20 20 20 20 20 20 20 20 20 20 20 20 20 20 10 
10 36 37 37 37 37 37 38 20 20 20 20 20 20 20 20 20 20 20 20 20 20 20 20 20 20 20 20 20 10 
10 10 10 10 10 10 10 10 10 10 10 10 10 10 10 10 10 10 10 10 10 10 10 10 10 10 10 10 10 10 
STARTPOINT
10 14 3
10 15 3
11 14 3
11 15 3
CHECKPOINT
10 2 1 
10 3 1 
10 4 1 
10 5 1 
10 6 1 
21 13 2 
22 13 2 
23 13 2 
24 13 2 
25 13 2 
26 13 2 
27 13 2 
28 13 2 
29 13 2 
