MAP
30 20
10 10 10 10 10 10 10 10 10 10 10 10 10 10 10 10 10 10 10 10 10 10 10 10 10 10 10 10 10 10
10 20 20 20 20 20 20 20 20 20 20 20 20 20 20 20 20 20 20 20 20 20 20 20 20 20 20 20 20 10
10 20 21 18 18 18 18 18 18 18 18 18 18 18 18 18 18 18 18 18 18 18 18 18 18 18 18 22 20 10
10 20 16 11 11 11 11 11 11 11 11 11 11 11 11 11 11 11 11 11 11 11 11 11 11 11 11 15 20 10
10 20 16 11 11 11 11 11 11 11 11 11 11 11 11 11 11 11 11 11 11 11 11 11 11 11 11 15 20 10
10 20 16 11 11 12 13 13 13 13 13 13 13 13 13 13 13 13 13 13 13 13 13 13 14 11 11 15 20 10
10 20 16 11 11 15 20 20 20 20 20 20 20 20 20 20 20 20 20 20 20 20 20 20 16 11 11 15 20 10
10 20 16 11 11 15 20 20 20 20 20 20 20 20 20 20 20 20 20 20 20 20 20 20 16 11 11 15 20 10
10 20 16 11 11 15 20 20 20 20 20 20 31 32 32 32 33 20 20 20 20 20 20 20 16 11 11 15 20 10
10 20 16 11 11 15 20 20 20 20 20 20 34 30 30 30 35 20 20 20 20 20 20 20 16 11 11 15 20 10
10 20 16 11 11 15 20 20 20 20 20 20 36 37 37 37 38 20 20 20 20 20 20 20 16 11 11 15 20 10
10 20 16 11 11 15 20 20 20 20 20 20 20 20 20 20 20 20 20 20 20 20 20 20 16 11 11 15 20 10
10 20 16 11 11 15 20 20 20 20 20 20 20 20 20 20 20 20 20 20 20 20 20 20 16 11 11 15 20 10
10 20 16 11 11 15 20 20 20 20 20 20 20 20 20 20 20 20 20 20 20 20 20 20 16 11 11 15 20 10
10 20 16 11 11 17 18 18 18 46 18 18 18 18 18 18 18 18 18 18 18 18 18 18 19 11 11 15 20 10
10 20 16 11 11 11 11 11 11 45 09 09 11 11 11 11 11 11 11 11 11 11 11 11 11 11 11 15 20 10
10 20 16 11 11 11 11 11 11 45 09 09 11 11 11 11 11 11 11 11 11 11 11 11 11 11 11 15 20 10
10 20 23 13 13 13 13 13 13 47 13 13 13 13 13 13 13 13 13 13 13 13 13 13 13 13 13 24 20 10
10 20 20 20 20 20 20 20 20 20 20 20 20 20 20 20 20 20 20 20 20 20 20 20 20 20 20 20 20 10
10 10 10 10 10 10 10 10 10 10 10 10 10 10 10 10 10 10 10 10 10 10 10 10 10 10 10 10 10 10
STARTPOINT
10 15 3
10 16 3
11 15 3
11 16 3
CHECKPOINT
07 16 01
07 17 01
04 14 02
05 14 02
04 07 03
05 07 03
08 04 04
08 05 04
23 04 05
23 05 05
26 08 06
27 08 06
26 14 07
27 14 07
20 16 08
20 17 08