MAP
30 30
10 10 10 10 10 10 10 10 10 10 10 10 10 10 10 10 10 10 10 10 10 10 10 10 10 10 10 10 10 10
10 21 18 18 18 18 18 18 18 18 22 10 21 18 18 18 18 18 18 18 18 18 18 18 18 18 18 22 20 10
10 16 11 11 11 11 11 11 11 11 15 10 16 11 11 11 11 11 11 11 11 11 11 11 11 11 11 15 20 10
10 16 11 11 11 11 11 11 11 11 15 10 16 11 11 11 11 11 11 11 11 11 11 11 11 11 11 15 20 10
10 16 11 11 12 13 13 14 11 11 15 10 16 11 11 12 13 13 13 13 13 13 13 13 14 11 11 15 20 10
10 16 11 11 15 10 20 16 11 11 15 10 16 11 11 15 10 10 10 10 10 10 10 10 16 11 11 15 20 10
10 16 11 11 15 10 20 16 11 11 15 10 16 11 11 15 10 20 21 18 18 18 18 18 19 11 11 15 20 10
10 16 11 11 15 10 20 16 11 11 15 10 16 11 11 15 10 20 16 11 11 11 11 11 11 11 11 15 20 10
10 16 11 11 15 10 20 16 11 11 17 18 19 11 11 15 10 20 16 11 11 11 11 11 11 11 11 15 20 10
10 16 11 11 15 10 20 16 11 11 11 11 11 11 11 15 10 20 16 11 11 11 11 11 11 11 11 15 20 10
10 16 11 11 15 10 20 16 11 11 11 11 11 11 11 15 10 20 16 11 11 10 10 10 10 10 10 10 10 10 
10 16 11 11 15 10 20 23 13 13 13 13 13 13 13 24 10 20 16 11 11 11 11 11 11 11 11 15 20 10
10 16 11 11 15 10 20 20 20 20 20 20 20 20 20 20 10 20 16 11 11 11 11 11 11 11 11 15 20 10
10 16 11 11 15 10 20 20 20 20 20 20 20 20 20 20 10 20 23 13 13 13 13 13 14 11 11 15 20 10
10 16 11 11 15 10 10 10 10 10 10 10 10 10 10 10 10 10 10 10 10 10 10 10 16 11 11 15 20 10
10 16 11 11 17 18 18 18 18 46 18 18 18 18 18 18 18 18 18 18 18 18 18 18 19 11 11 15 20 10
10 16 11 11 11 11 11 11 11 45 09 09 11 11 11 11 11 11 11 11 11 11 11 11 11 11 11 15 20 10
10 16 11 11 11 11 11 11 11 45 09 09 11 11 11 11 11 11 11 11 11 11 11 11 11 11 11 15 20 10
10 23 13 13 13 13 13 13 13 47 13 13 13 13 13 13 13 13 13 13 13 13 13 13 13 13 13 24 20 10
10 10 10 10 10 10 10 10 10 10 10 10 10 10 10 10 10 10 10 10 10 10 10 10 10 10 10 10 10 10
10 10 10 10 10 10 10 10 10 10 10 10 10 10 10 10 10 10 10 10 10 10 10 10 10 10 10 10 10 10
10 10 10 10 10 10 10 10 10 10 10 10 10 10 10 10 10 10 10 10 10 10 10 10 10 10 10 10 10 10
10 10 10 10 10 10 10 10 10 10 10 10 10 10 10 10 10 10 10 10 10 10 10 10 10 10 10 10 10 10
10 10 10 10 10 10 10 10 10 10 10 10 10 10 10 10 10 10 10 10 10 10 10 10 10 10 10 10 10 10
10 10 10 10 10 10 10 10 10 10 10 10 10 10 10 10 10 10 10 10 10 10 10 10 10 10 10 10 10 10
10 10 10 10 10 10 10 10 10 10 10 10 10 10 10 10 10 10 10 10 10 10 10 10 10 10 10 10 10 10
10 10 10 10 10 10 10 10 10 10 10 10 10 10 10 10 10 10 10 10 10 10 10 10 10 10 10 10 10 10
10 10 10 10 10 10 10 10 10 10 10 10 10 10 10 10 10 10 10 10 10 10 10 10 10 10 10 10 10 10
10 10 10 10 10 10 10 10 10 10 10 10 10 10 10 10 10 10 10 10 10 10 10 10 10 10 10 10 10 10
10 10 10 10 10 10 10 10 10 10 10 10 10 10 10 10 10 10 10 10 10 10 10 10 10 10 10 10 10 10
STARTPOINT
10 16 3
10 17 3
11 16 3
11 17 3
CHECKPOINT
07 16 01
07 17 01
07 18 01
07 19 01
02 10 02
03 10 02
04 10 02
05 10 02
06 02 03
06 03 03
06 04 03
06 05 03
12 09 04
12 10 04
12 11 04
12 12 04
19 02 05
19 03 05
19 04 05
19 05 05
25 06 06
26 06 06
27 06 06
28 06 06
18 11 07
19 11 07
20 11 07
21 11 07
25 15 08
26 15 08
27 15 08
28 15 08
20 16 09
20 17 09
20 18 09
20 19 09