10 10 10 10 10 10 10 10 10 10 10 10 10 10 10 10 10 10 10 10 10 10 10 10 10 10 10 10 10 10
10 21 18 18 18 18 18 18 18 18 22 10 21 18 18 18 18 18 18 18 18 18 18 18 18 18 18 22 20 10
10 16 11 11 11 11 11 11 11 11 15 10 16 11 11 11 11 11 11 11 11 11 11 11 11 11 11 15 20 10
10 16 11 11 11 11 11 11 11 11 15 10 16 11 11 11 11 11 11 11 11 11 11 11 11 11 11 15 20 10
10 16 11 11 12 13 13 14 11 11 15 10 16 11 11 12 13 13 13 13 13 13 13 13 14 11 11 15 20 10
10 16 11 11 15 10 20 16 11 11 15 10 16 11 11 15 10 10 10 10 10 10 10 10 16 11 11 15 20 10
10 16 11 11 15 10 20 16 11 11 15 10 16 11 11 15 10 20 21 18 18 18 18 18 19 11 11 15 20 10
10 16 11 11 15 10 20 16 11 11 15 10 16 11 11 15 10 20 16 11 11 11 11 11 11 11 11 15 20 10
10 16 11 11 15 10 20 16 11 11 17 18 19 11 11 15 10 20 16 11 11 11 11 11 11 11 11 15 20 10
10 16 11 11 15 10 20 16 11 11 11 11 11 11 11 15 10 20 16 11 11 11 11 11 11 11 11 15 20 10
10 16 11 11 15 10 20 16 11 11 11 11 11 11 11 15 10 20 16 11 11 10 10 10 10 10 10 10 10 10 
10 16 11 11 15 10 20 23 13 13 13 13 13 13 13 24 10 20 16 11 11 11 11 11 11 11 11 15 20 10
10 16 11 11 15 10 20 20 20 20 20 20 20 20 20 20 10 20 16 11 11 11 11 11 11 11 11 15 20 10
10 16 11 11 15 10 20 20 20 20 20 20 20 20 20 20 10 20 23 13 13 13 13 13 14 11 11 15 20 10
10 16 11 11 15 10 10 10 10 10 10 10 10 10 10 10 10 10 10 10 10 10 10 10 16 11 11 15 20 10
10 16 11 11 17 18 18 18 18 46 18 18 18 18 18 18 18 18 18 18 18 18 18 18 19 11 11 15 20 10
10 16 11 11 11 11 11 11 11 45 09 09 11 11 11 11 11 11 11 11 11 11 11 11 11 11 11 15 20 10
10 16 11 11 11 11 11 11 11 45 09 09 11 11 11 11 11 11 11 11 11 11 11 11 11 11 11 15 20 10
10 23 13 13 13 13 13 13 13 47 13 13 13 13 13 13 13 13 13 13 13 13 13 13 13 13 13 24 20 10
10 10 10 10 10 10 10 10 10 10 10 10 10 10 10 10 10 10 10 10 10 10 10 10 10 10 10 10 10 10