MAP
30 20
10 10 10 10 10 10 10 10 10 10 10 10 10 10 10 10 10 10 10 10 10 10 10 10 10 10 10 10 10 10 
10 20 20 20 20 20 20 20 20 20 20 20 20 20 20 20 20 20 20 20 20 20 20 20 20 20 20 20 20 10 
10 20 21 18 18 18 18 18 18 18 18 18 22 20 20 20 21 18 18 18 18 18 18 18 18 18 18 22 20 10 
10 20 16 11 11 11 11 11 11 11 11 11 15 20 20 20 16 11 11 11 11 11 11 11 11 11 11 15 20 10 
10 20 16 11 11 11 11 11 11 11 11 11 15 20 20 20 16 11 11 11 11 11 11 11 11 11 11 15 20 10 
10 20 16 11 11 12 13 13 13 13 13 13 24 20 20 20 23 13 13 13 13 13 13 13 14 11 11 15 20 10 
10 20 16 11 11 15 20 20 20 20 20 20 20 20 20 20 20 20 20 20 20 20 20 20 16 11 11 15 20 10 
10 20 16 11 11 15 20 20 20 20 20 20 20 20 20 20 20 20 20 20 20 20 20 20 16 11 11 15 20 10 
10 20 16 11 11 15 20 20 20 20 20 20 31 32 32 32 33 20 20 20 20 20 20 20 16 11 11 15 20 10 
10 20 16 11 11 15 20 20 20 20 20 20 34 30 30 30 35 20 20 20 20 20 20 20 16 11 11 15 20 10 
10 20 16 11 11 15 20 20 20 20 20 20 36 37 37 37 38 20 20 20 20 20 20 20 16 11 11 15 20 10 
10 20 16 11 11 15 20 20 20 20 20 20 20 20 20 20 20 20 20 20 20 20 20 20 16 11 11 15 20 10 
10 20 16 11 11 15 20 20 20 20 20 20 20 20 20 20 20 20 20 20 20 20 20 20 16 11 11 15 20 10 
10 20 16 11 11 15 20 20 20 20 20 20 20 20 20 20 20 20 20 20 20 20 20 20 16 11 11 15 20 10 
10 20 16 11 11 17 18 18 18 46 18 18 18 18 18 18 18 18 18 18 18 18 18 18 19 11 11 15 20 10 
10 20 16 11 11 11 11 11 11 45 9 9 11 11 11 11 11 11 11 11 11 11 11 11 11 11 11 15 20 10 
10 20 16 11 11 11 11 11 11 45 9 9 11 11 11 11 11 11 11 11 11 11 11 11 11 11 11 15 20 10 
10 20 23 13 13 13 13 13 13 47 13 13 13 13 13 13 13 13 13 13 13 13 13 13 13 13 13 24 20 10 
10 20 20 20 20 20 20 20 20 20 20 20 20 20 20 20 20 20 20 20 20 20 20 20 20 20 20 20 20 10 
10 10 10 10 10 10 10 10 10 10 10 10 10 10 10 10 10 10 10 10 10 10 10 10 10 10 10 10 10 10 
STARTPOINT
10 15 3
10 16 3
11 15 3
11 16 3
CHECKPOINT
2 10 1
3 10 1
4 10 1
5 10 1
6 10 1
7 10 1
8 10 1
9 10 1
10 10 1
11 10 1
12 10 1
15 2 2
15 3 2
15 4 2
15 5 2
15 6 2
15 7 2
15 8 2
18 10 3
19 10 3
20 10 3
21 10 3
22 10 3
23 10 3
24 10 3
25 10 3
26 10 3
27 10 3
28 10 3
29 10 3
